1111111111
1000100001
1020100001
1000000301
1000400001
1000000001
1111111111