1111111111111111111
1000000100002030001
1000040111000000001
1000000000000000001
1000000100200030001
1000000100200030001
1000000111000000001
1000000100002030001
1111111111111111111