111111111
100040001
101111101
101000101
101020101
100000001
100303201
111111111